1111111111111111111111111111111111111111111111111
@000000010000000000000000010000000000000000000001
1111111010111111111111111010111111111111111111101
1000000010100000000000001010100000000000000000101
1011111110101111111111101010101111111111111110101
1010000000101000000000101010101000000000000010101
1010111111101011111110101010101011111111111010101
1010100000001010000010101010101010000000001010101
1010101111111010111010101010101010111111101010101
1010101000000010101010101010101010100000101010101
1010101011111110101010101010101010101110101010101
1010101010000000101010101010101010101010101010101
1010101010111111101010101010101010101010101010101
1010101010100000001010101010101010101010101010101
1010101010101111111010101010101010101010101010101
1010101010101000000010101010101010101010101010101
1010101010101011111110101010101010101010101010101
1010101010101010000000101010101010101010101010101
1010101010101010111111101010101010101010101010101
1010101010101010100000001010101010101010101010101
1010101010101010101111111010101010101010101010101
1010101010101010101000000010101010101010101010101
1010101010101010101011111110101010101010101010101
1010101010101010101010000000101010101010101010101
1010101010101010101010111111101010101010101010101
1010101010101010101010100000001010101010101010101
1010101010101010101010101111111010101010101010101
1010101010101010101010101000000010101010101010101
1010101010101010101010101011111110101010101010101
1010101010101010101010101010000000101010101010101
1010101010101010101010101010111111101010101010101
1010101010101010101010101010100000001010101010101
1010101010101010101010101010101111111010101010101
1010101010101010101010101010101000000010101010101
1010101010101010101010101010101011111110101010101
1010101010101010101010101010101010000000101010101
1010101010101010101010101010101010111111101010101
1010101010101010101010101010101010100000001010101
1010101010101010101010101010101010101111111010101
1010101010101010101010101010101010101000000010101
1010101010101010101010101010101010101011111110101
1010101010101010101010101010101010101010000000101
1010101010101010101010101010101010101010111111101
1010101010101010101010101010101010101010100000001
1010101010101010101010101010101010101010101111111
1010101010101010101010101010101010101010100000001
1010101010101010101010101010101010101010101011101
1010101010101010101010101010101010101010101010001
111010000000000000000000000000000000000000000000E
1111111111111111111111111111111111111111111111111