111111111111111
@00010000010001
111010111010101
100010001000101
101111101111101
100000100000001
111110111110111
100000000010001
101111111011101
101000001000101
101011101111101
101010000000001
101110111111101
10000000000000E
111111111111111