1111111
@000001
1011101
1000101
1010001
100000E
1111111
