1111111111
1011000011
1011011111
1000011011
1011111011
101100000E
1011011111
1000011111
1011000001
1@11111111